{
    "internal_radius": 300, 
    "tile_height": 32, 
    "angular_width": 180,
    "tilegrid":[[7,7,7,7,7,7,7,7,7,7,7,7,7,7,7,7,7,7,7,7,7,7,7,7,7,7,7,7,7,7,7,7,7,7,7,7,7,7,7,7,7,7,7,7,7,7,7,7,7,7,7,7,7,7,7,7,7,4,4,4,7,7,7],
                [0,0,0,0,0,0,7,0,0,0,0,0,0,0,0,7,0,0,0,0,4,0,4,0,0,0,0,0,0,7,0,0,0,0,0,0,0,0,0,0,0,0,0,0,0,0,0,0,0,0,0,0,0,0,0,0,0,0,0,0,7,0,0],
                [0,0,0,0,0,0,7,0,0,0,0,0,0,0,0,7,0,0,0,0,4,0,4,0,0,0,0,0,0,7,0,0,0,0,0,0,0,0,0,0,0,0,0,0,0,0,0,0,0,0,0,0,0,0,0,0,0,0,0,0,7,0,0],
                [0,0,0,0,0,0,7,0,0,0,0,0,0,0,0,4,0,0,0,0,4,0,4,0,0,0,0,0,0,7,0,0,0,0,0,0,0,0,0,0,0,0,0,0,0,0,0,0,0,0,0,0,0,0,0,0,0,0,7,7,7,0,0],
                [0,0,0,0,0,0,7,0,0,0,0,0,0,0,0,4,0,0,0,0,7,0,7,7,7,7,7,0,0,7,0,0,0,0,0,7,7,7,0,0,0,7,7,7,7,7,7,7,7,7,7,7,7,7,0,0,0,0,7,7,7,0,0],
                [0,0,0,0,0,7,7,7,0,0,0,0,0,0,0,4,0,0,0,0,7,0,7,0,0,0,0,0,0,7,4,4,7,7,7,7,7,7,7,7,7,7,0,0,0,0,0,0,0,0,0,0,0,7,7,7,7,7,7,0,7,0,0],
                [0,0,0,7,7,7,7,7,7,7,0,0,0,0,0,7,0,0,0,0,7,0,7,0,0,0,0,0,0,7,0,0,0,0,0,7,7,7,0,0,0,0,0,0,0,0,0,0,0,0,0,0,0,0,0,0,0,0,0,0,7,0,0],
                [0,0,0,0,0,7,7,7,0,0,0,0,0,0,7,7,7,0,0,7,7,0,7,0,0,0,0,0,0,7,0,0,0,0,0,0,0,0,0,0,0,0,0,0,0,0,0,0,0,0,0,0,0,0,0,0,0,0,0,0,7,0,0],
                [0,0,0,0,0,0,7,0,0,0,0,7,7,7,7,7,7,7,7,7,7,0,7,0,0,0,0,0,0,7,0,0,0,0,0,0,0,0,0,0,0,0,0,0,0,0,0,0,0,0,0,0,0,0,0,0,0,0,0,0,7,0,0],
                [0,0,0,0,0,0,7,0,0,0,0,0,0,0,7,7,7,0,0,0,7,0,7,7,7,7,7,7,7,7,7,7,7,7,0,0,0,0,0,0,0,0,0,7,7,7,7,7,7,7,7,7,0,0,0,0,0,0,0,0,7,0,0],
                [0,0,0,0,0,0,7,0,0,0,0,0,0,0,0,7,0,0,0,0,7,0,0,0,0,0,0,0,0,7,0,0,0,7,7,7,7,7,7,7,7,7,7,7,0,0,0,0,0,0,0,7,7,7,7,7,4,7,7,7,7,0,0],
                [0,0,0,0,0,0,7,0,0,0,0,0,0,0,0,7,0,0,0,0,7,0,0,0,0,0,0,0,0,7,0,0,0,0,0,0,0,0,0,0,0,0,0,0,0,0,0,0,0,0,0,0,0,0,0,0,0,0,7,7,7,0,0],
                [4,0,0,0,0,0,0,0,0,0,0,0,0,0,0,7,0,0,0,0,4,0,0,0,0,0,0,0,0,4,0,0,0,0,0,0,0,0,0,0,0,0,0,0,0,0,0,0,0,0,0,0,0,0,0,0,0,0,7,7,7,0,0],
                [4,0,0,0,0,0,0,0,0,0,0,0,0,0,0,7,0,0,0,0,4,0,0,0,0,0,0,0,0,4,0,0,0,0,0,0,0,0,0,0,0,0,0,0,0,0,0,0,0,0,0,0,0,0,0,0,0,0,7,7,7,0,0],
                [4,0,0,0,0,0,0,0,0,0,0,0,0,0,0,7,0,0,0,0,4,0,0,0,0,0,0,0,0,4,0,0,0,0,0,0,0,0,0,0,0,0,0,0,0,0,0,0,0,0,0,0,0,0,0,0,0,0,7,7,7,0,0]]
}